"filename", "language", "Go", "comment", "blank", "total"
"/home/rafee/go/src/github.com/rafee/leetcode/1.two-sum.go", "Go", 46, 0, 4, 50
"/home/rafee/go/src/github.com/rafee/leetcode/1.two-sum_test.go", "Go", 70, 0, 4, 74
"/home/rafee/go/src/github.com/rafee/leetcode/10.regular-expression-matching.go", "Go", 101, 0, 6, 107
"/home/rafee/go/src/github.com/rafee/leetcode/10.regular-expression-matching_test.go", "Go", 136, 0, 4, 140
"/home/rafee/go/src/github.com/rafee/leetcode/100.same-tree.go", "Go", 103, 0, 8, 111
"/home/rafee/go/src/github.com/rafee/leetcode/100.same-tree_test.go", "Go", 107, 0, 5, 112
"/home/rafee/go/src/github.com/rafee/leetcode/1008.construct-binary-search-tree-from-preorder-traversal.go", "Go", 73, 0, 6, 79
"/home/rafee/go/src/github.com/rafee/leetcode/1008.construct-binary-search-tree-from-preorder-traversal_test.go", "Go", 93, 0, 5, 98
"/home/rafee/go/src/github.com/rafee/leetcode/1025.divisor-game.go", "Go", 80, 0, 4, 84
"/home/rafee/go/src/github.com/rafee/leetcode/1025.divisor-game_test.go", "Go", 99, 0, 4, 103
"/home/rafee/go/src/github.com/rafee/leetcode/1029.two-city-scheduling.go", "Go", 23, 0, 5, 28
"/home/rafee/go/src/github.com/rafee/leetcode/1029.two-city-scheduling_test.go", "Go", 26, 0, 4, 30
"/home/rafee/go/src/github.com/rafee/leetcode/103.binary-tree-zigzag-level-order-traversal.go", "Go", 40, 0, 5, 45
"/home/rafee/go/src/github.com/rafee/leetcode/103.binary-tree-zigzag-level-order-traversal_test.go", "Go", 49, 0, 5, 54
"/home/rafee/go/src/github.com/rafee/leetcode/1038.binary-search-tree-to-greater-sum-tree.go", "Go", 90, 0, 10, 100
"/home/rafee/go/src/github.com/rafee/leetcode/1038.binary-search-tree-to-greater-sum-tree_test.go", "Go", 105, 0, 5, 110
"/home/rafee/go/src/github.com/rafee/leetcode/1039.minimum-score-triangulation-of-polygon.go", "Go", 81, 0, 4, 85
"/home/rafee/go/src/github.com/rafee/leetcode/1039.minimum-score-triangulation-of-polygon_test.go", "Go", 110, 0, 4, 114
"/home/rafee/go/src/github.com/rafee/leetcode/104.maximum-depth-of-binary-tree.go", "Go", 53, 0, 4, 57
"/home/rafee/go/src/github.com/rafee/leetcode/104.maximum-depth-of-binary-tree_test.go", "Go", 57, 0, 4, 61
"/home/rafee/go/src/github.com/rafee/leetcode/1046.last-stone-weight.go", "Go", 98, 0, 11, 109
"/home/rafee/go/src/github.com/rafee/leetcode/1046.last-stone-weight_test.go", "Go", 189, 0, 10, 199
"/home/rafee/go/src/github.com/rafee/leetcode/105.construct-binary-tree-from-preorder-and-inorder-traversal.go", "Go", 32, 0, 6, 38
"/home/rafee/go/src/github.com/rafee/leetcode/105.construct-binary-tree-from-preorder-and-inorder-traversal_test.go", "Go", 60, 0, 5, 65
"/home/rafee/go/src/github.com/rafee/leetcode/11.container-with-most-water.go", "Go", 56, 0, 5, 61
"/home/rafee/go/src/github.com/rafee/leetcode/11.container-with-most-water_test.go", "Go", 79, 0, 4, 83
"/home/rafee/go/src/github.com/rafee/leetcode/113.path-sum-ii.go", "Go", 77, 0, 11, 88
"/home/rafee/go/src/github.com/rafee/leetcode/113.path-sum-ii_test.go", "Go", 69, 0, 4, 73
"/home/rafee/go/src/github.com/rafee/leetcode/114.flatten-binary-tree-to-linked-list.go", "Go", 28, 0, 5, 33
"/home/rafee/go/src/github.com/rafee/leetcode/114.flatten-binary-tree-to-linked-list_test.go", "Go", 46, 0, 5, 51
"/home/rafee/go/src/github.com/rafee/leetcode/1143.longest-common-subsequence.go", "Go", 82, 0, 5, 87
"/home/rafee/go/src/github.com/rafee/leetcode/1143.longest-common-subsequence_test.go", "Go", 99, 0, 4, 103
"/home/rafee/go/src/github.com/rafee/leetcode/119.pascals-triangle-ii.go", "Go", 69, 0, 6, 75
"/home/rafee/go/src/github.com/rafee/leetcode/119.pascals-triangle-ii_test.go", "Go", 64, 0, 4, 68
"/home/rafee/go/src/github.com/rafee/leetcode/1191.k-concatenation-maximum-sum.go", "Go", 64, 0, 4, 68
"/home/rafee/go/src/github.com/rafee/leetcode/1191.k-concatenation-maximum-sum_test.go", "Go", 80, 0, 4, 84
"/home/rafee/go/src/github.com/rafee/leetcode/1192.critical-connections-in-a-network.go", "Go", 98, 0, 6, 104
"/home/rafee/go/src/github.com/rafee/leetcode/1192.critical-connections-in-a-network_test.go", "Go", 105, 0, 5, 110
"/home/rafee/go/src/github.com/rafee/leetcode/121.best-time-to-buy-and-sell-stock.go", "Go", 60, 0, 5, 65
"/home/rafee/go/src/github.com/rafee/leetcode/121.best-time-to-buy-and-sell-stock_test.go", "Go", 73, 0, 4, 77
"/home/rafee/go/src/github.com/rafee/leetcode/122.best-time-to-buy-and-sell-stock-ii.go", "Go", 76, 0, 5, 81
"/home/rafee/go/src/github.com/rafee/leetcode/122.best-time-to-buy-and-sell-stock-ii_test.go", "Go", 84, 0, 4, 88
"/home/rafee/go/src/github.com/rafee/leetcode/1232.check-if-it-is-a-straight-line.go", "Go", 19, 0, 4, 23
"/home/rafee/go/src/github.com/rafee/leetcode/1232.check-if-it-is-a-straight-line_test.go", "Go", 40, 0, 4, 44
"/home/rafee/go/src/github.com/rafee/leetcode/124.binary-tree-maximum-path-sum.go", "Go", 94, 0, 7, 101
"/home/rafee/go/src/github.com/rafee/leetcode/124.binary-tree-maximum-path-sum_test.go", "Go", 113, 0, 6, 119
"/home/rafee/go/src/github.com/rafee/leetcode/1277.count-square-submatrices-with-all-ones.go", "Go", 39, 0, 6, 45
"/home/rafee/go/src/github.com/rafee/leetcode/1277.count-square-submatrices-with-all-ones_test.go", "Go", 55, 0, 5, 60
"/home/rafee/go/src/github.com/rafee/leetcode/13.roman-to-integer.go", "Go", 125, 0, 6, 131
"/home/rafee/go/src/github.com/rafee/leetcode/13.roman-to-integer_test.go", "Go", 103, 0, 5, 108
"/home/rafee/go/src/github.com/rafee/leetcode/130.surrounded-regions.go", "Go", 93, 0, 6, 99
"/home/rafee/go/src/github.com/rafee/leetcode/130.surrounded-regions_test.go", "Go", 154, 0, 5, 159
"/home/rafee/go/src/github.com/rafee/leetcode/131.palindrome-partitioning.go", "Go", 59, 0, 6, 65
"/home/rafee/go/src/github.com/rafee/leetcode/131.palindrome-partitioning_test.go", "Go", 81, 0, 5, 86
"/home/rafee/go/src/github.com/rafee/leetcode/1319.number-of-operations-to-make-network-connected.go", "Go", 94, 0, 5, 99
"/home/rafee/go/src/github.com/rafee/leetcode/1319.number-of-operations-to-make-network-connected_test.go", "Go", 97, 0, 4, 101
"/home/rafee/go/src/github.com/rafee/leetcode/132.palindrome-partitioning-ii.go", "Go", 36, 0, 5, 41
"/home/rafee/go/src/github.com/rafee/leetcode/132.palindrome-partitioning-ii_test.go", "Go", 70, 0, 4, 74
"/home/rafee/go/src/github.com/rafee/leetcode/136.single-number.go", "Go", 48, 0, 4, 52
"/home/rafee/go/src/github.com/rafee/leetcode/136.single-number_test.go", "Go", 59, 0, 4, 63
"/home/rafee/go/src/github.com/rafee/leetcode/137.single-number-ii.go", "Go", 11, 0, 4, 15
"/home/rafee/go/src/github.com/rafee/leetcode/137.single-number-ii_test.go", "Go", 26, 0, 4, 30
"/home/rafee/go/src/github.com/rafee/leetcode/139.word-break.go", "Go", 80, 0, 6, 86
"/home/rafee/go/src/github.com/rafee/leetcode/139.word-break_test.go", "Go", 142, 0, 6, 148
"/home/rafee/go/src/github.com/rafee/leetcode/14.longest-common-prefix.go", "Go", 60, 0, 6, 66
"/home/rafee/go/src/github.com/rafee/leetcode/14.longest-common-prefix_test.go", "Go", 61, 0, 4, 65
"/home/rafee/go/src/github.com/rafee/leetcode/141.linked-list-cycle.go", "Go", 90, 0, 5, 95
"/home/rafee/go/src/github.com/rafee/leetcode/141.linked-list-cycle_test.go", "Go", 89, 0, 4, 93
"/home/rafee/go/src/github.com/rafee/leetcode/145.binary-tree-postorder-traversal.go", "Go", 54, 0, 6, 60
"/home/rafee/go/src/github.com/rafee/leetcode/145.binary-tree-postorder-traversal_test.go", "Go", 57, 0, 4, 61
"/home/rafee/go/src/github.com/rafee/leetcode/146.lru-cache.go", "Go", 109, 0, 8, 117
"/home/rafee/go/src/github.com/rafee/leetcode/146.lru-cache_test.go", "Go", 163, 0, 8, 171
"/home/rafee/go/src/github.com/rafee/leetcode/148.sort-list.go", "Go", 41, 0, 5, 46
"/home/rafee/go/src/github.com/rafee/leetcode/148.sort-list_test.go", "Go", 53, 0, 5, 58
"/home/rafee/go/src/github.com/rafee/leetcode/15.3-sum.go", "Go", 69, 0, 11, 80
"/home/rafee/go/src/github.com/rafee/leetcode/15.3-sum_test.go", "Go", 103, 0, 4, 107
"/home/rafee/go/src/github.com/rafee/leetcode/152.maximum-product-subarray.go", "Go", 40, 0, 4, 44
"/home/rafee/go/src/github.com/rafee/leetcode/152.maximum-product-subarray_test.go", "Go", 74, 0, 4, 78
"/home/rafee/go/src/github.com/rafee/leetcode/153.find-minimum-in-rotated-sorted-array.go", "Go", 54, 0, 4, 58
"/home/rafee/go/src/github.com/rafee/leetcode/153.find-minimum-in-rotated-sorted-array_test.go", "Go", 60, 0, 4, 64
"/home/rafee/go/src/github.com/rafee/leetcode/16.3-sum-closest.go", "Go", 61, 0, 5, 66
"/home/rafee/go/src/github.com/rafee/leetcode/16.3-sum-closest_test.go", "Go", 54, 0, 4, 58
"/home/rafee/go/src/github.com/rafee/leetcode/160.intersection-of-two-linked-lists.go", "Go", 31, 0, 5, 36
"/home/rafee/go/src/github.com/rafee/leetcode/160.intersection-of-two-linked-lists_test.go", "Go", 50, 0, 5, 55
"/home/rafee/go/src/github.com/rafee/leetcode/162.find-peak-element.go", "Go", 76, 0, 4, 80
"/home/rafee/go/src/github.com/rafee/leetcode/162.find-peak-element_test.go", "Go", 69, 0, 4, 73
"/home/rafee/go/src/github.com/rafee/leetcode/169.majority-element.go", "Go", 49, 0, 4, 53
"/home/rafee/go/src/github.com/rafee/leetcode/169.majority-element_test.go", "Go", 65, 0, 4, 69
"/home/rafee/go/src/github.com/rafee/leetcode/17.letter-combinations-of-a-phone-number.go", "Go", 66, 0, 4, 70
"/home/rafee/go/src/github.com/rafee/leetcode/17.letter-combinations-of-a-phone-number_test.go", "Go", 64, 0, 4, 68
"/home/rafee/go/src/github.com/rafee/leetcode/173.binary-search-tree-iterator.go", "Go", 50, 0, 7, 57
"/home/rafee/go/src/github.com/rafee/leetcode/173.binary-search-tree-iterator_test.go", "Go", 61, 0, 6, 67
"/home/rafee/go/src/github.com/rafee/leetcode/189.rotate-array.go", "Go", 23, 0, 4, 27
"/home/rafee/go/src/github.com/rafee/leetcode/189.rotate-array_test.go", "Go", 24, 0, 4, 28
"/home/rafee/go/src/github.com/rafee/leetcode/19.remove-nth-node-from-end-of-list.go", "Go", 62, 0, 4, 66
"/home/rafee/go/src/github.com/rafee/leetcode/19.remove-nth-node-from-end-of-list_test.go", "Go", 61, 0, 4, 65
"/home/rafee/go/src/github.com/rafee/leetcode/190.reverse-bits.go", "Go", 18, 0, 4, 22
"/home/rafee/go/src/github.com/rafee/leetcode/190.reverse-bits_test.go", "Go", 26, 0, 4, 30
"/home/rafee/go/src/github.com/rafee/leetcode/191.number-of-1-bits.go", "Go", 16, 0, 4, 20
"/home/rafee/go/src/github.com/rafee/leetcode/191.number-of-1-bits_test.go", "Go", 26, 0, 4, 30
"/home/rafee/go/src/github.com/rafee/leetcode/198.house-robber.go", "Go", 56, 0, 4, 60
"/home/rafee/go/src/github.com/rafee/leetcode/198.house-robber_test.go", "Go", 75, 0, 4, 79
"/home/rafee/go/src/github.com/rafee/leetcode/2.add-two-numbers.go", "Go", 70, 0, 9, 79
"/home/rafee/go/src/github.com/rafee/leetcode/2.add-two-numbers_test.go", "Go", 56, 0, 4, 60
"/home/rafee/go/src/github.com/rafee/leetcode/20.valid-parentheses.go", "Go", 98, 0, 6, 104
"/home/rafee/go/src/github.com/rafee/leetcode/20.valid-parentheses_test.go", "Go", 120, 0, 9, 129
"/home/rafee/go/src/github.com/rafee/leetcode/200.number-of-islands.go", "Go", 78, 0, 6, 84
"/home/rafee/go/src/github.com/rafee/leetcode/200.number-of-islands_test.go", "Go", 110, 0, 6, 116
"/home/rafee/go/src/github.com/rafee/leetcode/201.bitwise-and-of-numbers-range.go", "Go", 40, 0, 4, 44
"/home/rafee/go/src/github.com/rafee/leetcode/201.bitwise-and-of-numbers-range_test.go", "Go", 62, 0, 4, 66
"/home/rafee/go/src/github.com/rafee/leetcode/202.happy-number.go", "Go", 56, 0, 5, 61
"/home/rafee/go/src/github.com/rafee/leetcode/202.happy-number_test.go", "Go", 89, 0, 5, 94
"/home/rafee/go/src/github.com/rafee/leetcode/204.count-primes.go", "Go", 21, 0, 4, 25
"/home/rafee/go/src/github.com/rafee/leetcode/204.count-primes_test.go", "Go", 26, 0, 4, 30
"/home/rafee/go/src/github.com/rafee/leetcode/206.reverse-linked-list.go", "Go", 52, 0, 6, 58
"/home/rafee/go/src/github.com/rafee/leetcode/206.reverse-linked-list_test.go", "Go", 54, 0, 4, 58
"/home/rafee/go/src/github.com/rafee/leetcode/207.course-schedule.go", "Go", 38, 0, 9, 47
"/home/rafee/go/src/github.com/rafee/leetcode/207.course-schedule_test.go", "Go", 52, 0, 5, 57
"/home/rafee/go/src/github.com/rafee/leetcode/208.implement-trie-prefix-tree.go", "Go", 62, 0, 8, 70
"/home/rafee/go/src/github.com/rafee/leetcode/208.implement-trie-prefix-tree_test.go", "Go", 82, 0, 7, 89
"/home/rafee/go/src/github.com/rafee/leetcode/21.merge-two-sorted-lists.go", "Go", 57, 0, 6, 63
"/home/rafee/go/src/github.com/rafee/leetcode/21.merge-two-sorted-lists_test.go", "Go", 58, 0, 5, 63
"/home/rafee/go/src/github.com/rafee/leetcode/213.house-robber-ii.go", "Go", 65, 0, 3, 68
"/home/rafee/go/src/github.com/rafee/leetcode/213.house-robber-ii_test.go", "Go", 83, 0, 4, 87
"/home/rafee/go/src/github.com/rafee/leetcode/215.kth-largest-element-in-an-array.go", "Go", 67, 0, 7, 74
"/home/rafee/go/src/github.com/rafee/leetcode/215.kth-largest-element-in-an-array_test.go", "Go", 105, 0, 6, 111
"/home/rafee/go/src/github.com/rafee/leetcode/216.combination-sum-iii.go", "Go", 26, 0, 5, 31
"/home/rafee/go/src/github.com/rafee/leetcode/216.combination-sum-iii_test.go", "Go", 53, 0, 5, 58
"/home/rafee/go/src/github.com/rafee/leetcode/217.contains-duplicate.go", "Go", 18, 0, 4, 22
"/home/rafee/go/src/github.com/rafee/leetcode/217.contains-duplicate_test.go", "Go", 26, 0, 4, 30
"/home/rafee/go/src/github.com/rafee/leetcode/22.generate-parentheses.go", "Go", 54, 0, 5, 59
"/home/rafee/go/src/github.com/rafee/leetcode/22.generate-parentheses_test.go", "Go", 81, 0, 5, 86
"/home/rafee/go/src/github.com/rafee/leetcode/221.maximal-square.go", "Go", 56, 0, 4, 60
"/home/rafee/go/src/github.com/rafee/leetcode/221.maximal-square_test.go", "Go", 52, 0, 4, 56
"/home/rafee/go/src/github.com/rafee/leetcode/226.invert-binary-tree.go", "Go", 22, 0, 4, 26
"/home/rafee/go/src/github.com/rafee/leetcode/226.invert-binary-tree_test.go", "Go", 29, 0, 4, 33
"/home/rafee/go/src/github.com/rafee/leetcode/228.summary-ranges.go", "Go", 37, 0, 6, 43
"/home/rafee/go/src/github.com/rafee/leetcode/228.summary-ranges_test.go", "Go", 49, 0, 5, 54
"/home/rafee/go/src/github.com/rafee/leetcode/23.merge-k-sorted-lists.go", "Go", 63, 0, 8, 71
"/home/rafee/go/src/github.com/rafee/leetcode/23.merge-k-sorted-lists_test.go", "Go", 64, 0, 4, 68
"/home/rafee/go/src/github.com/rafee/leetcode/230.kth-smallest-element-in-a-bst.go", "Go", 34, 0, 5, 39
"/home/rafee/go/src/github.com/rafee/leetcode/230.kth-smallest-element-in-a-bst_test.go", "Go", 55, 0, 5, 60
"/home/rafee/go/src/github.com/rafee/leetcode/231.power-of-two.go", "Go", 11, 0, 4, 15
"/home/rafee/go/src/github.com/rafee/leetcode/231.power-of-two_test.go", "Go", 26, 0, 4, 30
"/home/rafee/go/src/github.com/rafee/leetcode/237.delete-node-in-a-linked-list.go", "Go", 27, 0, 4, 31
"/home/rafee/go/src/github.com/rafee/leetcode/237.delete-node-in-a-linked-list_test.go", "Go", 23, 0, 4, 27
"/home/rafee/go/src/github.com/rafee/leetcode/238.product-of-array-except-self.go", "Go", 53, 0, 6, 59
"/home/rafee/go/src/github.com/rafee/leetcode/238.product-of-array-except-self_test.go", "Go", 65, 0, 4, 69
"/home/rafee/go/src/github.com/rafee/leetcode/24.swap-nodes-in-pairs.go", "Go", 47, 0, 4, 51
"/home/rafee/go/src/github.com/rafee/leetcode/24.swap-nodes-in-pairs_test.go", "Go", 53, 0, 4, 57
"/home/rafee/go/src/github.com/rafee/leetcode/240.search-a-2-d-matrix-ii.go", "Go", 77, 0, 5, 82
"/home/rafee/go/src/github.com/rafee/leetcode/240.search-a-2-d-matrix-ii_test.go", "Go", 87, 0, 5, 92
"/home/rafee/go/src/github.com/rafee/leetcode/26.remove-duplicates-from-sorted-array.go", "Go", 79, 0, 4, 83
"/home/rafee/go/src/github.com/rafee/leetcode/26.remove-duplicates-from-sorted-array_test.go", "Go", 97, 0, 4, 101
"/home/rafee/go/src/github.com/rafee/leetcode/263.ugly-number.go", "Go", 74, 0, 4, 78
"/home/rafee/go/src/github.com/rafee/leetcode/263.ugly-number_test.go", "Go", 84, 0, 4, 88
"/home/rafee/go/src/github.com/rafee/leetcode/264.ugly-number-ii.go", "Go", 30, 0, 4, 34
"/home/rafee/go/src/github.com/rafee/leetcode/264.ugly-number-ii_test.go", "Go", 26, 0, 4, 30
"/home/rafee/go/src/github.com/rafee/leetcode/268.missing-number.go", "Go", 15, 0, 4, 19
"/home/rafee/go/src/github.com/rafee/leetcode/268.missing-number_test.go", "Go", 26, 0, 4, 30
"/home/rafee/go/src/github.com/rafee/leetcode/278.first-bad-version.go", "Go", 65, 0, 6, 71
"/home/rafee/go/src/github.com/rafee/leetcode/278.first-bad-version_test.go", "Go", 80, 0, 5, 85
"/home/rafee/go/src/github.com/rafee/leetcode/28.implement-str-str.go", "Go", 58, 0, 4, 62
"/home/rafee/go/src/github.com/rafee/leetcode/28.implement-str-str_test.go", "Go", 89, 0, 4, 93
"/home/rafee/go/src/github.com/rafee/leetcode/283.move-zeroes.go", "Go", 44, 0, 4, 48
"/home/rafee/go/src/github.com/rafee/leetcode/283.move-zeroes_test.go", "Go", 75, 0, 4, 79
"/home/rafee/go/src/github.com/rafee/leetcode/3.longest-substring-without-repeating-characters.go", "Go", 74, 0, 4, 78
"/home/rafee/go/src/github.com/rafee/leetcode/3.longest-substring-without-repeating-characters_test.go", "Go", 77, 0, 4, 81
"/home/rafee/go/src/github.com/rafee/leetcode/30.substring-with-concatenation-of-all-words.go", "Go", 77, 0, 5, 82
"/home/rafee/go/src/github.com/rafee/leetcode/30.substring-with-concatenation-of-all-words_test.go", "Go", 93, 0, 4, 97
"/home/rafee/go/src/github.com/rafee/leetcode/303.range-sum-query-immutable.go", "Go", 57, 0, 6, 63
"/home/rafee/go/src/github.com/rafee/leetcode/303.range-sum-query-immutable_test.go", "Go", 80, 0, 5, 85
"/home/rafee/go/src/github.com/rafee/leetcode/306.additive-number.go", "Go", 36, 0, 4, 40
"/home/rafee/go/src/github.com/rafee/leetcode/306.additive-number_test.go", "Go", 53, 0, 5, 58
"/home/rafee/go/src/github.com/rafee/leetcode/32.longest-valid-parentheses.go", "Go", 72, 0, 5, 77
"/home/rafee/go/src/github.com/rafee/leetcode/32.longest-valid-parentheses_test.go", "Go", 65, 0, 4, 69
"/home/rafee/go/src/github.com/rafee/leetcode/322.coin-change.go", "Go", 74, 0, 8, 82
"/home/rafee/go/src/github.com/rafee/leetcode/322.coin-change_test.go", "Go", 60, 0, 4, 64
"/home/rafee/go/src/github.com/rafee/leetcode/328.odd-even-linked-list.go", "Go", 36, 0, 7, 43
"/home/rafee/go/src/github.com/rafee/leetcode/328.odd-even-linked-list_test.go", "Go", 73, 0, 6, 79
"/home/rafee/go/src/github.com/rafee/leetcode/329.longest-increasing-path-in-a-matrix.go", "Go", 62, 0, 7, 69
"/home/rafee/go/src/github.com/rafee/leetcode/329.longest-increasing-path-in-a-matrix_test.go", "Go", 76, 0, 6, 82
"/home/rafee/go/src/github.com/rafee/leetcode/33.search-in-rotated-sorted-array.go", "Go", 71, 0, 6, 77
"/home/rafee/go/src/github.com/rafee/leetcode/33.search-in-rotated-sorted-array_test.go", "Go", 75, 0, 4, 79
"/home/rafee/go/src/github.com/rafee/leetcode/332.reconstruct-itinerary.go", "Go", 34, 0, 6, 40
"/home/rafee/go/src/github.com/rafee/leetcode/332.reconstruct-itinerary_test.go", "Go", 29, 0, 4, 33
"/home/rafee/go/src/github.com/rafee/leetcode/334.increasing-triplet-subsequence.go", "Go", 22, 0, 5, 27
"/home/rafee/go/src/github.com/rafee/leetcode/334.increasing-triplet-subsequence_test.go", "Go", 26, 0, 4, 30
"/home/rafee/go/src/github.com/rafee/leetcode/337.house-robber-iii.go", "Go", 79, 0, 6, 85
"/home/rafee/go/src/github.com/rafee/leetcode/337.house-robber-iii_test.go", "Go", 101, 0, 5, 106
"/home/rafee/go/src/github.com/rafee/leetcode/338.counting-bits.go", "Go", 15, 0, 4, 19
"/home/rafee/go/src/github.com/rafee/leetcode/338.counting-bits_test.go", "Go", 29, 0, 4, 33
"/home/rafee/go/src/github.com/rafee/leetcode/34.find-first-and-last-position-of-element-in-sorted-array.go", "Go", 70, 0, 9, 79
"/home/rafee/go/src/github.com/rafee/leetcode/34.find-first-and-last-position-of-element-in-sorted-array_test.go", "Go", 69, 0, 4, 73
"/home/rafee/go/src/github.com/rafee/leetcode/344.reverse-string.go", "Go", 55, 0, 6, 61
"/home/rafee/go/src/github.com/rafee/leetcode/344.reverse-string_test.go", "Go", 66, 0, 4, 70
"/home/rafee/go/src/github.com/rafee/leetcode/35.search-insert-position.go", "Go", 20, 0, 4, 24
"/home/rafee/go/src/github.com/rafee/leetcode/35.search-insert-position_test.go", "Go", 27, 0, 4, 31
"/home/rafee/go/src/github.com/rafee/leetcode/350.intersection-of-two-arrays-ii.go", "Go", 26, 0, 5, 31
"/home/rafee/go/src/github.com/rafee/leetcode/350.intersection-of-two-arrays-ii_test.go", "Go", 30, 0, 4, 34
"/home/rafee/go/src/github.com/rafee/leetcode/36.valid-sudoku.go", "Go", 39, 0, 6, 45
"/home/rafee/go/src/github.com/rafee/leetcode/36.valid-sudoku_test.go", "Go", 26, 0, 4, 30
"/home/rafee/go/src/github.com/rafee/leetcode/367.valid-perfect-square.go", "Go", 24, 0, 4, 28
"/home/rafee/go/src/github.com/rafee/leetcode/367.valid-perfect-square_test.go", "Go", 26, 0, 4, 30
"/home/rafee/go/src/github.com/rafee/leetcode/368.largest-divisible-subset.go", "Go", 41, 0, 5, 46
"/home/rafee/go/src/github.com/rafee/leetcode/368.largest-divisible-subset_test.go", "Go", 29, 0, 4, 33
"/home/rafee/go/src/github.com/rafee/leetcode/37.sudoku-solver.go", "Go", 111, 0, 13, 124
"/home/rafee/go/src/github.com/rafee/leetcode/37.sudoku-solver_test.go", "Go", 219, 0, 10, 229
"/home/rafee/go/src/github.com/rafee/leetcode/373.find-k-pairs-with-smallest-sums.go", "Go", 56, 0, 15, 71
"/home/rafee/go/src/github.com/rafee/leetcode/373.find-k-pairs-with-smallest-sums_test.go", "Go", 123, 0, 9, 132
"/home/rafee/go/src/github.com/rafee/leetcode/374.guess-number-higher-or-lower.go", "Go", 70, 0, 6, 76
"/home/rafee/go/src/github.com/rafee/leetcode/374.guess-number-higher-or-lower_test.go", "Go", 81, 0, 5, 86
"/home/rafee/go/src/github.com/rafee/leetcode/38.count-and-say.go", "Go", 85, 0, 5, 90
"/home/rafee/go/src/github.com/rafee/leetcode/38.count-and-say_test.go", "Go", 105, 0, 4, 109
"/home/rafee/go/src/github.com/rafee/leetcode/380.insert-delete-get-random-o-1.go", "Go", 55, 0, 9, 64
"/home/rafee/go/src/github.com/rafee/leetcode/380.insert-delete-get-random-o-1_test.go", "Go", 81, 0, 7, 88
"/home/rafee/go/src/github.com/rafee/leetcode/381.insert-delete-get-random-o-1-duplicates-allowed.go", "Go", 70, 0, 9, 79
"/home/rafee/go/src/github.com/rafee/leetcode/381.insert-delete-get-random-o-1-duplicates-allowed_test.go", "Go", 81, 0, 7, 88
"/home/rafee/go/src/github.com/rafee/leetcode/383.ransom-note.go", "Go", 56, 0, 6, 62
"/home/rafee/go/src/github.com/rafee/leetcode/383.ransom-note_test.go", "Go", 69, 0, 4, 73
"/home/rafee/go/src/github.com/rafee/leetcode/386.lexicographical-numbers.go", "Go", 43, 0, 4, 47
"/home/rafee/go/src/github.com/rafee/leetcode/386.lexicographical-numbers_test.go", "Go", 69, 0, 5, 74
"/home/rafee/go/src/github.com/rafee/leetcode/387.first-unique-character-in-a-string.go", "Go", 48, 0, 6, 54
"/home/rafee/go/src/github.com/rafee/leetcode/387.first-unique-character-in-a-string_test.go", "Go", 63, 0, 4, 67
"/home/rafee/go/src/github.com/rafee/leetcode/39.combination-sum.go", "Go", 79, 0, 6, 85
"/home/rafee/go/src/github.com/rafee/leetcode/39.combination-sum_test.go", "Go", 102, 0, 5, 107
"/home/rafee/go/src/github.com/rafee/leetcode/392.is-subsequence.go", "Go", 70, 0, 4, 74
"/home/rafee/go/src/github.com/rafee/leetcode/392.is-subsequence_test.go", "Go", 84, 0, 4, 88
"/home/rafee/go/src/github.com/rafee/leetcode/395.longest-substring-with-at-least-k-repeating-characters.go", "Go", 27, 0, 4, 31
"/home/rafee/go/src/github.com/rafee/leetcode/395.longest-substring-with-at-least-k-repeating-characters_test.go", "Go", 36, 0, 4, 40
"/home/rafee/go/src/github.com/rafee/leetcode/4.median-of-two-sorted-arrays.go", "Go", 87, 0, 9, 96
"/home/rafee/go/src/github.com/rafee/leetcode/4.median-of-two-sorted-arrays_test.go", "Go", 63, 0, 4, 67
"/home/rafee/go/src/github.com/rafee/leetcode/40.combination-sum-ii.go", "Go", 81, 0, 7, 88
"/home/rafee/go/src/github.com/rafee/leetcode/40.combination-sum-ii_test.go", "Go", 102, 0, 5, 107
"/home/rafee/go/src/github.com/rafee/leetcode/402.remove-k-digits.go", "Go", 11, 0, 4, 15
"/home/rafee/go/src/github.com/rafee/leetcode/402.remove-k-digits_test.go", "Go", 27, 0, 4, 31
"/home/rafee/go/src/github.com/rafee/leetcode/406.queue-reconstruction-by-height.go", "Go", 37, 0, 10, 47
"/home/rafee/go/src/github.com/rafee/leetcode/406.queue-reconstruction-by-height_test.go", "Go", 102, 0, 8, 110
"/home/rafee/go/src/github.com/rafee/leetcode/409.longest-palindrome.go", "Go", 60, 0, 5, 65
"/home/rafee/go/src/github.com/rafee/leetcode/409.longest-palindrome_test.go", "Go", 63, 0, 4, 67
"/home/rafee/go/src/github.com/rafee/leetcode/415.add-strings.go", "Go", 42, 0, 7, 49
"/home/rafee/go/src/github.com/rafee/leetcode/415.add-strings_test.go", "Go", 51, 0, 5, 56
"/home/rafee/go/src/github.com/rafee/leetcode/43.multiply-strings.go", "Go", 70, 0, 4, 74
"/home/rafee/go/src/github.com/rafee/leetcode/43.multiply-strings_test.go", "Go", 74, 0, 4, 78
"/home/rafee/go/src/github.com/rafee/leetcode/438.find-all-anagrams-in-a-string.go", "Go", 31, 0, 4, 35
"/home/rafee/go/src/github.com/rafee/leetcode/438.find-all-anagrams-in-a-string_test.go", "Go", 39, 0, 4, 43
"/home/rafee/go/src/github.com/rafee/leetcode/445.add-two-numbers-ii.go", "Go", 86, 0, 11, 97
"/home/rafee/go/src/github.com/rafee/leetcode/445.add-two-numbers-ii_test.go", "Go", 106, 0, 6, 112
"/home/rafee/go/src/github.com/rafee/leetcode/451.sort-characters-by-frequency.go", "Go", 80, 0, 13, 93
"/home/rafee/go/src/github.com/rafee/leetcode/451.sort-characters-by-frequency_test.go", "Go", 145, 0, 10, 155
"/home/rafee/go/src/github.com/rafee/leetcode/46.permutations.go", "Go", 57, 0, 4, 61
"/home/rafee/go/src/github.com/rafee/leetcode/46.permutations_test.go", "Go", 57, 0, 4, 61
"/home/rafee/go/src/github.com/rafee/leetcode/461.hamming-distance.go", "Go", 17, 0, 4, 21
"/home/rafee/go/src/github.com/rafee/leetcode/461.hamming-distance_test.go", "Go", 27, 0, 4, 31
"/home/rafee/go/src/github.com/rafee/leetcode/463.island-perimeter.go", "Go", 11, 0, 4, 15
"/home/rafee/go/src/github.com/rafee/leetcode/463.island-perimeter_test.go", "Go", 26, 0, 4, 30
"/home/rafee/go/src/github.com/rafee/leetcode/468.validate-ip-address.go", "Go", 62, 0, 7, 69
"/home/rafee/go/src/github.com/rafee/leetcode/468.validate-ip-address_test.go", "Go", 68, 0, 6, 74
"/home/rafee/go/src/github.com/rafee/leetcode/476.number-complement.go", "Go", 66, 0, 5, 71
"/home/rafee/go/src/github.com/rafee/leetcode/476.number-complement_test.go", "Go", 79, 0, 4, 83
"/home/rafee/go/src/github.com/rafee/leetcode/48.rotate-image.go", "Go", 81, 0, 4, 85
"/home/rafee/go/src/github.com/rafee/leetcode/48.rotate-image_test.go", "Go", 92, 0, 4, 96
"/home/rafee/go/src/github.com/rafee/leetcode/49.group-anagrams.go", "Go", 82, 0, 16, 98
"/home/rafee/go/src/github.com/rafee/leetcode/49.group-anagrams_test.go", "Go", 157, 0, 9, 166
"/home/rafee/go/src/github.com/rafee/leetcode/493.reverse-pairs.go", "Go", 62, 0, 6, 68
"/home/rafee/go/src/github.com/rafee/leetcode/493.reverse-pairs_test.go", "Go", 99, 0, 5, 104
"/home/rafee/go/src/github.com/rafee/leetcode/5.longest-palindromic-substring.go", "Go", 64, 0, 6, 70
"/home/rafee/go/src/github.com/rafee/leetcode/5.longest-palindromic-substring_test.go", "Go", 114, 0, 6, 120
"/home/rafee/go/src/github.com/rafee/leetcode/50.pow-x-n.go", "Go", 72, 0, 5, 77
"/home/rafee/go/src/github.com/rafee/leetcode/50.pow-x-n_test.go", "Go", 90, 0, 5, 95
"/home/rafee/go/src/github.com/rafee/leetcode/509.fibonacci-number.go", "Go", 82, 0, 6, 88
"/home/rafee/go/src/github.com/rafee/leetcode/509.fibonacci-number_test.go", "Go", 80, 0, 4, 84
"/home/rafee/go/src/github.com/rafee/leetcode/51.n-queens.go", "Go", 107, 0, 11, 118
"/home/rafee/go/src/github.com/rafee/leetcode/51.n-queens_test.go", "Go", 179, 0, 9, 188
"/home/rafee/go/src/github.com/rafee/leetcode/518.coin-change-2.go", "Go", 11, 0, 4, 15
"/home/rafee/go/src/github.com/rafee/leetcode/518.coin-change-2_test.go", "Go", 27, 0, 4, 31
"/home/rafee/go/src/github.com/rafee/leetcode/52.n-queens-ii.go", "Go", 99, 0, 11, 110
"/home/rafee/go/src/github.com/rafee/leetcode/52.n-queens-ii_test.go", "Go", 182, 0, 9, 191
"/home/rafee/go/src/github.com/rafee/leetcode/525.contiguous-array.go", "Go", 63, 0, 4, 67
"/home/rafee/go/src/github.com/rafee/leetcode/525.contiguous-array_test.go", "Go", 71, 0, 4, 75
"/home/rafee/go/src/github.com/rafee/leetcode/528.random-pick-with-weight.go", "Go", 45, 0, 8, 53
"/home/rafee/go/src/github.com/rafee/leetcode/528.random-pick-with-weight_test.go", "Go", 65, 0, 6, 71
"/home/rafee/go/src/github.com/rafee/leetcode/53.maximum-subarray.go", "Go", 49, 0, 5, 54
"/home/rafee/go/src/github.com/rafee/leetcode/53.maximum-subarray_test.go", "Go", 55, 0, 4, 59
"/home/rafee/go/src/github.com/rafee/leetcode/540.single-element-in-a-sorted-array.go", "Go", 23, 0, 4, 27
"/home/rafee/go/src/github.com/rafee/leetcode/540.single-element-in-a-sorted-array_test.go", "Go", 45, 0, 4, 49
"/home/rafee/go/src/github.com/rafee/leetcode/543.diameter-of-binary-tree.go", "Go", 68, 0, 7, 75
"/home/rafee/go/src/github.com/rafee/leetcode/543.diameter-of-binary-tree_test.go", "Go", 87, 0, 5, 92
"/home/rafee/go/src/github.com/rafee/leetcode/55.jump-game.go", "Go", 55, 0, 4, 59
"/home/rafee/go/src/github.com/rafee/leetcode/55.jump-game_test.go", "Go", 73, 0, 4, 77
"/home/rafee/go/src/github.com/rafee/leetcode/560.subarray-sum-equals-k.go", "Go", 48, 0, 4, 52
"/home/rafee/go/src/github.com/rafee/leetcode/560.subarray-sum-equals-k_test.go", "Go", 65, 0, 4, 69
"/home/rafee/go/src/github.com/rafee/leetcode/567.permutation-in-string.go", "Go", 30, 0, 4, 34
"/home/rafee/go/src/github.com/rafee/leetcode/567.permutation-in-string_test.go", "Go", 36, 0, 4, 40
"/home/rafee/go/src/github.com/rafee/leetcode/61.rotate-list.go", "Go", 68, 0, 6, 74
"/home/rafee/go/src/github.com/rafee/leetcode/61.rotate-list_test.go", "Go", 96, 0, 4, 100
"/home/rafee/go/src/github.com/rafee/leetcode/62.unique-paths.go", "Go", 77, 0, 4, 81
"/home/rafee/go/src/github.com/rafee/leetcode/62.unique-paths_test.go", "Go", 83, 0, 4, 87
"/home/rafee/go/src/github.com/rafee/leetcode/629.k-inverse-pairs-array.go", "Go", 11, 0, 4, 15
"/home/rafee/go/src/github.com/rafee/leetcode/629.k-inverse-pairs-array_test.go", "Go", 27, 0, 4, 31
"/home/rafee/go/src/github.com/rafee/leetcode/64.minimum-path-sum.go", "Go", 110, 0, 17, 127
"/home/rafee/go/src/github.com/rafee/leetcode/64.minimum-path-sum_test.go", "Go", 280, 0, 16, 296
"/home/rafee/go/src/github.com/rafee/leetcode/66.plus-one.go", "Go", 23, 0, 4, 27
"/home/rafee/go/src/github.com/rafee/leetcode/66.plus-one_test.go", "Go", 29, 0, 4, 33
"/home/rafee/go/src/github.com/rafee/leetcode/678.valid-parenthesis-string.go", "Go", 82, 0, 5, 87
"/home/rafee/go/src/github.com/rafee/leetcode/678.valid-parenthesis-string_test.go", "Go", 96, 0, 4, 100
"/home/rafee/go/src/github.com/rafee/leetcode/684.redundant-connection.go", "Go", 85, 0, 5, 90
"/home/rafee/go/src/github.com/rafee/leetcode/684.redundant-connection_test.go", "Go", 101, 0, 4, 105
"/home/rafee/go/src/github.com/rafee/leetcode/69.sqrt-x.go", "Go", 58, 0, 4, 62
"/home/rafee/go/src/github.com/rafee/leetcode/69.sqrt-x_test.go", "Go", 75, 0, 4, 79
"/home/rafee/go/src/github.com/rafee/leetcode/7.reverse-integer.go", "Go", 76, 0, 5, 81
"/home/rafee/go/src/github.com/rafee/leetcode/7.reverse-integer_test.go", "Go", 66, 0, 4, 70
"/home/rafee/go/src/github.com/rafee/leetcode/70.climbing-stairs.go", "Go", 67, 0, 6, 73
"/home/rafee/go/src/github.com/rafee/leetcode/70.climbing-stairs_test.go", "Go", 65, 0, 4, 69
"/home/rafee/go/src/github.com/rafee/leetcode/700.search-in-a-binary-search-tree.go", "Go", 78, 0, 6, 84
"/home/rafee/go/src/github.com/rafee/leetcode/700.search-in-a-binary-search-tree_test.go", "Go", 73, 0, 4, 77
"/home/rafee/go/src/github.com/rafee/leetcode/704.binary-search.go", "Go", 64, 0, 4, 68
"/home/rafee/go/src/github.com/rafee/leetcode/704.binary-search_test.go", "Go", 70, 0, 4, 74
"/home/rafee/go/src/github.com/rafee/leetcode/72.edit-distance.go", "Go", 29, 0, 6, 35
"/home/rafee/go/src/github.com/rafee/leetcode/72.edit-distance_test.go", "Go", 31, 0, 4, 35
"/home/rafee/go/src/github.com/rafee/leetcode/73.set-matrix-zeroes.go", "Go", 57, 0, 8, 65
"/home/rafee/go/src/github.com/rafee/leetcode/73.set-matrix-zeroes_test.go", "Go", 72, 0, 6, 78
"/home/rafee/go/src/github.com/rafee/leetcode/743.network-delay-time.go", "Go", 89, 0, 8, 97
"/home/rafee/go/src/github.com/rafee/leetcode/743.network-delay-time_test.go", "Go", 74, 0, 4, 78
"/home/rafee/go/src/github.com/rafee/leetcode/746.min-cost-climbing-stairs.go", "Go", 59, 0, 4, 63
"/home/rafee/go/src/github.com/rafee/leetcode/746.min-cost-climbing-stairs_test.go", "Go", 79, 0, 4, 83
"/home/rafee/go/src/github.com/rafee/leetcode/75.sort-colors.go", "Go", 23, 0, 4, 27
"/home/rafee/go/src/github.com/rafee/leetcode/75.sort-colors_test.go", "Go", 34, 0, 4, 38
"/home/rafee/go/src/github.com/rafee/leetcode/76.minimum-window-substring.go", "Go", 85, 0, 10, 95
"/home/rafee/go/src/github.com/rafee/leetcode/76.minimum-window-substring_test.go", "Go", 80, 0, 4, 84
"/home/rafee/go/src/github.com/rafee/leetcode/77.combinations.go", "Go", 51, 0, 4, 55
"/home/rafee/go/src/github.com/rafee/leetcode/77.combinations_test.go", "Go", 63, 0, 4, 67
"/home/rafee/go/src/github.com/rafee/leetcode/771.jewels-and-stones.go", "Go", 62, 0, 4, 66
"/home/rafee/go/src/github.com/rafee/leetcode/771.jewels-and-stones_test.go", "Go", 77, 0, 4, 81
"/home/rafee/go/src/github.com/rafee/leetcode/779.k-th-symbol-in-grammar.go", "Go", 70, 0, 6, 76
"/home/rafee/go/src/github.com/rafee/leetcode/779.k-th-symbol-in-grammar_test.go", "Go", 113, 0, 5, 118
"/home/rafee/go/src/github.com/rafee/leetcode/78.subsets.go", "Go", 52, 0, 4, 56
"/home/rafee/go/src/github.com/rafee/leetcode/78.subsets_test.go", "Go", 84, 0, 4, 88
"/home/rafee/go/src/github.com/rafee/leetcode/787.cheapest-flights-within-k-stops.go", "Go", 12, 0, 4, 16
"/home/rafee/go/src/github.com/rafee/leetcode/787.cheapest-flights-within-k-stops_test.go", "Go", 39, 0, 4, 43
"/home/rafee/go/src/github.com/rafee/leetcode/79.word-search.go", "Go", 90, 0, 9, 99
"/home/rafee/go/src/github.com/rafee/leetcode/79.word-search_test.go", "Go", 153, 0, 6, 159
"/home/rafee/go/src/github.com/rafee/leetcode/8.string-to-integer-atoi.go", "Go", 142, 0, 5, 147
"/home/rafee/go/src/github.com/rafee/leetcode/8.string-to-integer-atoi_test.go", "Go", 177, 0, 5, 182
"/home/rafee/go/src/github.com/rafee/leetcode/821.shortest-distance-to-a-character.go", "Go", 26, 0, 6, 32
"/home/rafee/go/src/github.com/rafee/leetcode/821.shortest-distance-to-a-character_test.go", "Go", 34, 0, 4, 38
"/home/rafee/go/src/github.com/rafee/leetcode/844.backspace-string-compare.go", "Go", 138, 0, 14, 152
"/home/rafee/go/src/github.com/rafee/leetcode/844.backspace-string-compare_test.go", "Go", 216, 0, 9, 225
"/home/rafee/go/src/github.com/rafee/leetcode/876.middle-of-the-linked-list.go", "Go", 77, 0, 4, 81
"/home/rafee/go/src/github.com/rafee/leetcode/876.middle-of-the-linked-list_test.go", "Go", 80, 0, 4, 84
"/home/rafee/go/src/github.com/rafee/leetcode/88.merge-sorted-array.go", "Go", 31, 0, 6, 37
"/home/rafee/go/src/github.com/rafee/leetcode/88.merge-sorted-array_test.go", "Go", 26, 0, 4, 30
"/home/rafee/go/src/github.com/rafee/leetcode/886.possible-bipartition.go", "Go", 41, 0, 7, 48
"/home/rafee/go/src/github.com/rafee/leetcode/886.possible-bipartition_test.go", "Go", 49, 0, 5, 54
"/home/rafee/go/src/github.com/rafee/leetcode/9.palindrome-number.go", "Go", 60, 0, 4, 64
"/home/rafee/go/src/github.com/rafee/leetcode/9.palindrome-number_test.go", "Go", 69, 0, 4, 73
"/home/rafee/go/src/github.com/rafee/leetcode/90.subsets-ii.go", "Go", 78, 0, 8, 86
"/home/rafee/go/src/github.com/rafee/leetcode/90.subsets-ii_test.go", "Go", 115, 0, 6, 121
"/home/rafee/go/src/github.com/rafee/leetcode/901.online-stock-span.go", "Go", 37, 0, 6, 43
"/home/rafee/go/src/github.com/rafee/leetcode/901.online-stock-span_test.go", "Go", 45, 0, 5, 50
"/home/rafee/go/src/github.com/rafee/leetcode/912.sort-an-array.go", "Go", 61, 0, 6, 67
"/home/rafee/go/src/github.com/rafee/leetcode/912.sort-an-array_test.go", "Go", 81, 0, 5, 86
"/home/rafee/go/src/github.com/rafee/leetcode/914.x-of-a-kind-in-a-deck-of-cards.go", "Go", 36, 0, 7, 43
"/home/rafee/go/src/github.com/rafee/leetcode/914.x-of-a-kind-in-a-deck-of-cards_test.go", "Go", 30, 0, 4, 34
"/home/rafee/go/src/github.com/rafee/leetcode/918.maximum-sum-circular-subarray.go", "Go", 25, 0, 5, 30
"/home/rafee/go/src/github.com/rafee/leetcode/918.maximum-sum-circular-subarray_test.go", "Go", 45, 0, 4, 49
"/home/rafee/go/src/github.com/rafee/leetcode/93.restore-ip-addresses.go", "Go", 52, 0, 7, 59
"/home/rafee/go/src/github.com/rafee/leetcode/93.restore-ip-addresses_test.go", "Go", 80, 0, 6, 86
"/home/rafee/go/src/github.com/rafee/leetcode/94.binary-tree-inorder-traversal.go", "Go", 74, 0, 7, 81
"/home/rafee/go/src/github.com/rafee/leetcode/94.binary-tree-inorder-traversal_test.go", "Go", 118, 0, 7, 125
"/home/rafee/go/src/github.com/rafee/leetcode/95.unique-binary-search-trees-ii.go", "Go", 76, 0, 6, 82
"/home/rafee/go/src/github.com/rafee/leetcode/95.unique-binary-search-trees-ii_test.go", "Go", 85, 0, 5, 90
"/home/rafee/go/src/github.com/rafee/leetcode/96.unique-binary-search-trees.go", "Go", 47, 0, 4, 51
"/home/rafee/go/src/github.com/rafee/leetcode/96.unique-binary-search-trees_test.go", "Go", 59, 0, 4, 63
"/home/rafee/go/src/github.com/rafee/leetcode/973.k-closest-points-to-origin.go", "Go", 81, 0, 22, 103
"/home/rafee/go/src/github.com/rafee/leetcode/973.k-closest-points-to-origin_test.go", "Go", 195, 0, 13, 208
"/home/rafee/go/src/github.com/rafee/leetcode/98.validate-binary-search-tree.go", "Go", 86, 0, 8, 94
"/home/rafee/go/src/github.com/rafee/leetcode/98.validate-binary-search-tree_test.go", "Go", 135, 0, 6, 141
"/home/rafee/go/src/github.com/rafee/leetcode/986.interval-list-intersections.go", "Go", 29, 0, 5, 34
"/home/rafee/go/src/github.com/rafee/leetcode/986.interval-list-intersections_test.go", "Go", 55, 0, 5, 60
"/home/rafee/go/src/github.com/rafee/leetcode/99.recover-binary-search-tree.go", "Go", 23, 0, 5, 28
"/home/rafee/go/src/github.com/rafee/leetcode/993.cousins-in-binary-tree.go", "Go", 117, 0, 5, 122
"/home/rafee/go/src/github.com/rafee/leetcode/993.cousins-in-binary-tree_test.go", "Go", 118, 0, 5, 123
"/home/rafee/go/src/github.com/rafee/leetcode/997.find-the-town-judge.go", "Go", 21, 0, 6, 27
"/home/rafee/go/src/github.com/rafee/leetcode/997.find-the-town-judge_test.go", "Go", 27, 0, 4, 31
"/home/rafee/go/src/github.com/rafee/leetcode/bst.go", "Go", 7, 0, 2, 9
"/home/rafee/go/src/github.com/rafee/leetcode/listNode.go", "Go", 50, 0, 11, 61
"/home/rafee/go/src/github.com/rafee/leetcode/listNode_test.go", "Go", 139, 0, 9, 148
"/home/rafee/go/src/github.com/rafee/leetcode/networkGraph.go", "Go", 67, 0, 12, 79
"/home/rafee/go/src/github.com/rafee/leetcode/networkGraph_test.go", "Go", 147, 0, 10, 157
"/home/rafee/go/src/github.com/rafee/leetcode/numFunc.go", "Go", 24, 0, 5, 29
"/home/rafee/go/src/github.com/rafee/leetcode/numFunc_test.go", "Go", 77, 0, 5, 82
"/home/rafee/go/src/github.com/rafee/leetcode/unionfind.go", "Go", 56, 0, 13, 69
"/home/rafee/go/src/github.com/rafee/leetcode/unionfind_test.go", "Go", 123, 0, 8, 131
"Total", "-", 26446, 0, 2154, 28600